#####################
#SXXXX#XXX#X#XXX#####
###X###X#X#X###X#XX##
#XXXXXXX###X###X#X###
#X#####XXXXX#XXXXX###
###XX######X#X#X#####
####X##XXXXX#X#XXXX##
#XXXXXXX###XXX#######
#X#####XX#########X##
#X##X###X##XXX####X##
#XXXX###X####XXXXXX##
######XXX######X#####
####XXX#XXXXXXXXXXXX#
####X#######X######X#
#XXXX###XXXXX########
###X####X###XXXXXXX##
###X##############X##
#XXXXX##XX##XXXX##X##
#####XXXX###G##XXXXX#
####################
