####################
#S####XXXXXXXXXXXXX#
#X####X###########X#
#X####X###########X#
#X####X###########X#
#XXXXXX#####X#####X#
######X#####X#####X#
######X#####X#######
######X#####X#######
##XXXXXXXXXXXXXXXXX#
##X###X##########X##
##X###X######G###X##
##X###X######X###X##
#XXXXXX######X###X##
######X######X###X##
#####XX######X###X##
#####X#######X###X##
#####X#######XXXXX##
#####XXXX###########
####################
