####################
#X####XXXXXXXXXXXXX##
#X####X###########X#
#X####X###########X#
#X####X######XXXXXX#
#XXXXXX######X######
######X######X######
######X######XXXG###
##XXXXXX############
##X#################
##X###XXXXXXXXXXXXX##
##X###X##########X##
##X###X##########X##
#XXXXXX##########X##
######X##########X##
#####XX##########X##
#####X###########X##
#####X###########X##
#####XXXXXXXXS######
####################
